11111111111111111
1P000000000001E01
111000C0000110011
1100C000000000001
11000000000C00101
11000000011000001
11000001000000001
1010C000000010001
10000000C00000001
11111111111111111