11111111111111111
1P000000000001001
111000C0000110E11
1100C000000000001
11000000000C00101
11000000011000001
11000001000000001
1010C0000000100G1
10000000C00000001
10000000C00G00001
1G000001000000001
1010C000000010001
1100000100000G001
1010C000G00010001
10000000000000001
11111111111111111
